NO                                     ./texture/wall.xpm

WE ./texture/wall.xpm



C 225,30,0
EA ./texture/wall.xpm
SO ./texture/wall.xpm
F                           220,100,0

111111111111111111111111111
	100000000000000000000001
   100000000000000000000001
   100000000000000000000001
    100000111110000101010001
11110001000100000000000011111111111
10N000100010000100010001
100000100010000000000001
100000110110000101010001
100000000000000000000001
10000000000000000000001
111111111111111111111111

111111111111111111111111
100000000000000000000001111
1111100000000000000000000001
    10000000000000000000001
11111111111111111111111111
