NO                                     ./texture/wall.xpm

WE ./texture/wall.xpm



C 225,30,0
EA ./texture/wall.xpm
SO ./texture/wall.xpm
F                           220,100,0


111111111111111111111111111111
111111111000000000000000011111
100000000000000000111000100001
110000100000000111000000001111
1000011111110001 10000000111111
111111100000000111000000000001
1111000000N0001100000000000011
100000000000000000000000000001
110000000000011110000000000011
100000000000111000000000000011
110000000000111000000000001111
110000000001111000000000000111
111111111111111111111111111111111