
NO ./texture/wall.xpm
WE ./texture/wall.xpm


EA ./texture/wall.xpm
SO ./texture/wall.xpm
C 128,128,128
F 176,48,48



1111111111111111111111111
10000000000000000000000111
11100000000000000000000001
   100000000000000000000001
    100000111110000101010001
11110001000100000000000011111111111
100000100010000100000010001
10000010001000N000000000001
100000001101100000001010101
100000000000000000000000001
100000000000000000000000001
100000000000000000000001111
1111100000000000000000000001
1000000000000000000000000001
111111111111111111111111111