NO                                     ./path_to_the_north_texture

WE ./path_to_the_west_texture



C 225,30,0
EA ./path_to_the_east_texture
SO ./path_to_the_south_texture
F                           220,100,0


111111111111111111111111111111
111111111000000000000000011111
100000000000000000111000100001
110000100000000000000000001111
100001111111000000000000111111
111111100000000000000000000001
1111000000N0001100000000000011
100000000000000000000000000001
110000000000011110000000000011
100000000000111000000000000011
110000000000111000000000001111
110000000001111000000000000111
111111111111111111111111111111111