NO                                     ./path_to_the_north_texture
SO ./path_to_the_south_texture
WE ./path_to_the_west_texture
EA ./path_to_the_east_texture
F                           220,100,0
C 225,30,0


11111111111111111111111111111111111
11100000000000000000000000000000001
11110000000000000000000000000000011
11000000000000000000000000011111111
111111111000000000011111111111
11111111101100100111000000001
10000000001101 100111011111111
11110111111110101N00000010001
11110111111111011101010010001
11000000110101011100000010001
10000000000000001100000010001
10000000000000001101010010001
11001001110101011111011110001
1111 111011101010101111010001
1111 111111111111111111111111