NO                                     ./path_to_the_north_texture

WE ./path_to_the_west_texture



C 225,30,0
EA ./path_to_the_east_texture
SO ./path_to_the_south_texture
F                           220,100,0


11111111111111111111111111111111111
11100000000000000000011 11100000001
111100000000000000000011111100000011
11000000000000000000000000011111111
111111111000000000011111111111
1111111101100100111000000001
100000000011011100111011111111
11110111111110101100000010001
11110111111111011101010010001
11000000110101011100000010001
10000000000000001100000010001
10000000000000001101010010001
11001011110101011111011110001
11111111011101010101111010001
11111111111111111111111111111