NO                                     ./texture/wall.xpm

WE ./texture/wall.xpm



C 225,30,0
EA ./texture/wall.xpm
SO ./texture/wall.xpm
F                           220,100,0

111111111111111111111111
100000000000000000000001
100000000000000000000001
100000000000000000000001
100000111110000101010001
100000100010000000000001
100000100010000100010001
100000100010000000000001
100000110110000101010001
1000000000N0000000000001
100000000000000000000001
100000000000000000000001
100000000000000000000001
100000000000000000000001
111111111111111111111111
