
NO ./texture/wall.xpm
WE ./texture/wall.xpm


       

EA ./texture/wall.xpm
SO ./texture/wall.xpm
     
C 128,128,128












F 176,48,48










111111111111111111111111111
  100000000000000000000001
   100000000000000000000001
   100000000000000000000001
    100000111110000101010001
11110001000100000000000011111111111
10N000100010000100010001
100000100010000000000001
100000110110000101010001
100000000000000000000001
10000000000000000000001
100000000000000000000001111
111110000000000000000000001
    1000000000000000000001
11111111111111111111111111









