NO ./texture/wall.xpm
WE ./texture/wall.xpm


EA ./texture/wall.xpm
SO ./texture/wall.xpm




F 0,0,0
C 225,225,0


11111111111111111111111111111
1N00000000110000000000001
1011000001110000000000001
1001000000000000000000001
1111111110110000011100001
1000000000110000013110111111111
111101110011000011100000010001
111101110000000111010000010001
110000001100000111000000010001
100000000000000000000000000001
100000000000000000000000000001
110000011101010111111111000011
11110111 1110101 111111000001 
11111111 1111111 111111111111