
NO ./texture/wall_5.xpm
WE ./texture/Grass.xpm

EA ./texture/Marble.xpm
SO ./texture/Stone.xpm
C 121,125,127
F 28,40,51

F 28,0,150

 1111111111111111111111111
100000000000000000000000001
100000000000000000000011111            
100000000W00000000000000001   
100000000000000000000000001
110000000000000011111111111
110000000000000000000000011
100000000000000000000000001
100000000000000000000000001
110000000000000011111111111
100000000000000000000000001
 1111111111111111111111111