NO ./texture/wall.xpm
WE ./texture/wall.xpm

EA ./texture/wall.xpm
SO ./texture/wall.xpm
C 128,128,128
F 176,48,48
11111
10111
10111 
10111
100N01
11111
 