
NO ./texture/wall.xpm
WE ./texture/wall.xpm


EA ./texture/wall.xpm
SO ./texture/wall.xpm
C 121,125,127
F 28,40,51


1111111111111111111111111111
  100000000000000000000001
   10000000S000000000000001
   100000000000000000000001
    100000111110000101010001
11110001000100000000000011111111111
100000100010000100010001
100000100010000000000001
100000110110000101010001
100000000000000000000001
10000000000000000000001
100000000000000000000001111
11111000000000000000000000011
    10000000000000000000001
    111111111111111111111111
